NO ../textures/north.xpm
SO ../textures/south.xpm
WE ../textures/west.xpm
EA ../textures/east.xpm

F 220,100,0
C 225,30,0

11111111
11101111
10000001
10000001
10000001
10000N01
10000001
10000001
10000001
10000001
10000001
11111111