NO ./doom_wall.xpm
SO ./doom_wall2.xpm
WE ./doom_wall3.xpm
EA ./doom_wall4.xpm

C 35,19,73
F 15,6,40

               11111111111111111
               10000000001100001
               10000000000000001
11111111111111110000000000000001
10000000000000000000000000000001111111111111111111111
10000000000000000000000000000000000000000000000000001
10000000000000000000000000000000000000000000000000001
10000000000000000000010000000000000000000000000000001
100000000000000000001 1000000000000000000M00000000001
10000000000000000000010000000000000000000000000001111
10000000000000000000000000000000000000010000000001
10000000000000000000000000000000000000010000000001
1000000000000000001110000000000E0000000D000000001111
1000000000000000001 10000000000000000001000000000001
1000000000000000001 10000000000000000001000000000001
1111111111111111111 11111111111111111111111111111111

