NO textures/north.xpm
SO textures/south.xpm
WE textures/west.xpm
EA textures/east.xpm

F 220,100,0
C 225,30,0

               11111111111111111
               10000000001100001
               10000000000000001
11111111111111110000000000000001
10000000000000000000000000000001111111111111111111111
10000000000000000000000000000000000000000000000000001
10000000000000000000000000000000000000000000000000001
10000000000000000000000000000000000000000000000000001
10000000000000000000000000000000000000000000000000001
10000000000000000000000000000000000000000000000001111
10000000000000000000000000000000000000000000000001
10000000000000000000000000000000000000000000000001
1000000000000000001110000000000000000000000000001111
1000000000000000001 10000000000000000000000000000001
1000000000000000001 10000000000000000S00000000000001
1111111111111111111 11111111111111111111111111111111
